一二九运动纪念日	festival
全民国家安全日	festival
七夕节	festival
万圣节	festival
上九节	festival
上巳节	festival
下元节	festival
双十二	festival
双十一	festival
世界人口日	festival
世界人权日	festival
世界传统医药日	festival
世界动物日	festival
世界勤俭日	festival
世界卫生日	festival
世界地球日	festival
世界居住条件调查日	festival
世界帕金森病日	festival
世界微笑日	festival
世界旅游日	festival
世界无烟日	festival
世界无肉日	festival
世界无车日	festival
世界标准日	festival
世界气象日	festival
世界水日	festival
世界清洁地球日	festival
世界湿地日	festival
世界犀牛日	festival
世界环境日	festival
世界电信日	festival
世界睡眠日	festival
世界粮食日	festival
世界糖尿病日	festival
世界红十字日	festival
世界艾滋病日	festival
世界读书日	festival
世界足球日	festival
世界邮政日	festival
世界问候日	festival
世界难民日	festival
世界青年联欢节	festival
世界青年节	festival
中元节	festival
中华慈善日	festival
中和节	festival
中国人口日	festival
中国儿童慈善活动日	festival
中国共产党诞生日	festival
中国少年先锋队诞辰日	festival
中国记者日	festival
中秋节	festival
中秋	festival
乌日贡节	festival
九一八事变纪念日	festival
二月八年节	festival
五一劳动节	festival
五卅运动纪念	festival
人人公益节	festival
以赶年	festival
仫佬族二月春社日	festival
佛诞节	festival
佤族新米节	festival
侗族姑娘节	festival
侗族斗牛节	festival
侗族赶歌会	festival
俄喜节	festival
僳僳族收获节	festival
僳僳族过年节	festival
儿童节	festival
元宵节	festival
元日	festival
元旦	festival
元旦节	festival
元春	festival
元月	festival
光棍节	festival
全国交通安全反思日	festival
全国助残日	festival
全国土地日	festival
全国爱眼日	festival
全国爱耳日	festival
关门节	festival
冬至	festival
六一	festival
五一	festival
劳动节	festival
南京大屠杀纪念日	festival
厚南节	festival
古尔邦节	festival
吃信节	festival
吃新节	festival
吃立节	festival
吉佳姆	festival
吉时	TIME
响浪节	festival
唱哈节	festival
国庆放假	festival
国庆节	festival
国庆	festival
礼拜	festival
清朝	festival
国际体育记者日	festival
国际儿童图书日	festival
国际儿童日	festival
国际博物馆日	festival
国际和平日	festival
国际声援南非日	festival
国际大学生节	festival
国际奥林匹克日	festival
国际家庭日	festival
国际扫盲日	festival
国际护士节	festival
国际接吻日	festival
国际残疾人日	festival
国际气象节	festival
国际海豹日	festival
国际消除贫困日	festival
国际爱牙日	festival
国际电影节	festival
上海国际电影节	festival
国际盲人节	festival
国际禁毒日	festival
国际篮球日	festival
国际聋人节	festival
国际臭氧层保护日	festival
国际航海日	festival
国际音乐节	festival
国际麻风节	festival
圣纪节	festival
圣诞节	festival
地藏节	festival
壮族三月三歌会	festival
壮族陀螺节	festival
复活节	festival
夏至	festival
大十五节	festival
妇女节	festival
姓氏节	festival
娅拜节	festival
学雷锋日	festival
寅时	TIME
寒衣节	festival
寒食节	festival
尝新节	festival
巴罗提节	festival
布依族三月三	festival
布依族六月六	festival
布依族四月八	festival
布依族大年辰	festival
干巴节	festival
库尔班节	festival
庚辰	TIME
建党节	festival
建军节	festival
开斋节	festival
开门节	festival
怒族仙女节	festival
怒族汝为	festival
怒族祭谷神	festival
怒族鲜花节	festival
愚人节	festival
感恩节	festival
戌时	TIME
扎勒特	festival
抗日战争纪念日	festival
抹黑节	festival
拉祜族八月月圆节	festival
拉祜族火把节	festival
插种节	festival
插花节	festival
教师节	festival
日本投降日	festival
日羌节	festival

昂德林节	festival
春社日	festival
春节	festival
春龙节	festival
晒霉节	festival
普米族大过年	festival
普米族转山会	festival
晾桥节	festival
月半节	festival
望果节	festival
查干萨仁	festival
查白歌节	festival
植树节	festival
正月	festival
母亲节	festival
泼水节	festival
浴佛节	festival
消费者权益日	festival
添仓节	festival
清明节	festival
清末	festival
澡塘会	festival
澳门回归纪念日	festival
火把节	festival
爱牙日	festival
父亲节	festival
独龙族卡雀哇	festival
瑶族晒衣节	festival
白族三月街	festival
白族大过年	festival
白族绕三灵	festival
白族耍海会	festival
白色情人节	festival
白露	festival
盍司节	festival
盘王节	festival
知识产权日	festival
矻扎扎节	festival
砍火星节	festival
祝著节	festival
祭祖节	festival
秋分	festival
立冬	festival
立春	festival
端午节	festival
端午	festival
爱胃月	festival
跨年夜	festival
辛巳月	festival
辞旧月	festival
第三世界青年日	festival
米阔鲁节	festival
纳吾鲁孜节	festival
纳西族农具会	festival
纳西族朝山会	festival
纳西族骡马会	festival
纳西族龙王会	festival
罗让扎花节	festival
羌族祭山大典	festival
老人节	festival
耍歌堂节	festival
耶苦扎	festival
联合国日	festival
肉孜节	festival
腊八节	festival
舟溪芦笙节	festival
花山节	festival
花朝节	festival
花炮节	festival
苗年	festival
苗族四月八	festival
苗族捕鱼节	festival
苗族苗年	festival
苗族龙舟节	festival
蒙古族白月	festival
蒙古族白节	festival
藏历新年	festival
新年	festival
藏族沐浴节	festival
藏族赏花节	festival
藏族转山会	festival
藏族驱鬼节	festival
西迁节	festival
译腊和实	festival
诺鲁孜节	festival
诺鲁孜节节	festival
赶秋节	festival
跳公节	festival
辛亥革命纪念日	festival
达努节	festival
达玛节	festival
迄脱乞迪尔节	festival
送穷节	festival
那达慕	festival
郎扎热甲节	festival
酥油花灯节	festival
重阳节	festival
阔时节	festival
阿昌族耍白象	festival
世界精神卫生日	festival
陇端节	festival
除夕	festival
雪顿节	festival
零时	TIME
零点	TIME
雷锋纪念日	festival
青年节	festival
非洲妇女日	festival
香港回归日	festival
香港回归纪念日	festival
马奶节	festival
黑人日	festival
龙舟节	festival
情人节	festival
午讯	DATE
早评	DATE
早讯	DATE
晚评	DATE
晚讯	DATE
今日	DATE
粽子节	festival
August	DATE
下个月	DATE
上个月	DATE
上星期	DATE
上个星期	DATE
下星期	DATE
上周	DATE
下周	DATE
下个星期	DATE
上礼拜	DATE
上个礼拜	DATE
下礼拜	DATE
下个礼拜	DATE
一季度	DATE
二季度	DATE
三季度	DATE
四季度	DATE
近几个月	DATE
上季	DATE
下季	DATE
近期	DATE
近来	DATE
昨	DATE
昨天	DATE
昨日	DATE
今天	DATE
今日	DATE
最近	DATE
目前	DATE
上日	DATE
上周六	DATE
上周日	DATE
上周五	DATE
上周四	DATE
上周三	DATE
上周二	DATE
上周一	DATE
上周6	DATE
上周5	DATE
上周4	DATE
上周3	DATE
上周2	DATE
上周1	DATE
下周六	DATE
下周日	DATE
下周五	DATE
下周四	DATE
下周三	DATE
下周二	DATE
下周一	DATE
下周6	DATE
下周5	DATE
下周4	DATE
下周3	DATE
下周2	DATE
下周1	DATE
日前	DATE
周末	DATE
月初	DATE
月底	DATE
月末	DATE
下周	DATE
晚间	DATE
# 早安	DATE
# 晚安	DATE
# 午安	DATE
#午休	DATE
近日	DATE
今儿	DATE
夏日	DATE
大年二十九	DATE
大年二十八	DATE
大年二十七	DATE
大年二十六	DATE
大年二十五	DATE
大年二十四	DATE
大年二十三	DATE
大年二十二	DATE
大年二十一	DATE
今年正月	DATE
20192020	DATE
2020澳网	event
2020年美网	event
2020厦门马拉松	event
2020马拉松	event
美网2020	event
2020BMW锦标赛	event
2020年锦标赛	event
2020赛季	event
2020巴黎-尼斯	event
2020阿德莱德顶级赛	event
2020年中超联赛	event
2020羽超联赛	event
2020中超	event
2020/21赛季	event
2020CBA选秀	event
法网2020	event
2020中国平安中超联赛	event
2020NBA季后赛	event
2020全国女排锦标赛	event
2020年环法自行车赛	event
2020羽超联赛	event
2019-2020中国男排超级联赛	event
2020年全国女排锦标赛	event
2020年亚冠	event
2020匈牙利公开赛	event
2020NBA全明星	event
今日俄罗斯	ORG
前些天	DATE
这些天	DATE
这几天	DATE
那几天	DATE
上月	DATE
下月	DATE
今日	DATE
今天	DATE
昨日	DATE
昨天	DATE
前日	DATE
前天	DATE




